##############################
#S#.#.#.#.......#...#.....#...
#.#.#.#.#######.#.#####.###.##
#...#...#...#...#...#.....#.#.
#.#.###.#.#####.#.#####.###.#.
#.#.....#...#.....#.#.#.#...#.
#.###.#.###.###.###.#.#.###.#.
#.#...#.......#.......#.#...#.
#############.###.#####.#.#.#.
#...#.#.#.......#.#.#.....#...
###.#.#.#####.###.#.#.########
#.....#...#.......#...........
#####.#.###.###.#.#.#####.#.#.
#.#...#.#.#.#.#.#...#...#.#.#.
#.###.#.#.###.###.#####.#####.
#.#...#.....#...#.#.#.#.#.#.#.
#.###.#####.###.#.#.#.#.#.#.##
#.#.#...#.....#...#.#...#.....
#.#.###.#####.#.###.#.###.####
#.#...#.....#.#.#.#.#.#...#...
#.#.#######.#.#.#.#.#.#.###.##
#.#...#...........#...#.#.#.#.
#.#.###########.#####.#.#.#.#.
#.......#.#.#.#.#.#.#.#.......
###.#.###.#.#.#.#.#.#.#.######
#...#.........#.#...........#.
#.#.#.#####.#.#.#.###.#######.
#.#.#.#.....#.......#.....#.#.
###.###########.#.#.#.#.#.#.T.
#...#...........#.#.#.#.#.....
