##############################
#S..#.#.#.#...#.#...#.........
###.#.#.#.###.#.#.###.###.####
#.#.#.#.#.#.#.#.#...#...#.#...
#.#.#.#.#.#.#.#.#.#.#.###.#.##
#...#.#...#.#...#.#...#.#.#.#.
###.#.###.#.###.#.#####.###.#.
#...#.........#...............
#.#########.###.#.#########.##
#...#.#...#.....#.........#...
###.#.###.#####.#####.########
#...................#.......#.
#####.#.###.###.#.###.#.#####.
#.....#.#...#...#...#.#.......
###.#.###.#.#####.#######.#.##
#...#...#.#...#.........#.#.#.
#.#.#.###.#.#.###.###########.
#.#.#...#.#.#.#...........#...
###.###.#.#####.###.###.#.#.##
#.#...#.#...#...#.....#.#.....
#.#.###.###.#.###.#.#######.#.
#.....#.#...#...#.#.#.....#.#.
#.#####.#.#.#.#.#.#.#.###.###.
#.....#.#.#.#.#.#.#.....#...#.
#.#.###.###.#####.#.###.###.##
#.#.#...#.......#.#.#.#...#...
#####.#####.#.#####.#.###.####
#.........#.#.#.........#.....
###.###.#.#####.#.#.###.#.#.T#
#.....#.#.#.....#.#...#.#.#...
